EA ./assets/textures/Pat1.xpm
NO 		./assets/textures/Pat3.xpm


F 105,105,105
SO ./assets/textures/Pat4.xpm

WE    ./assets/textures/Pat2.xpm
//EA ./path_to_the_east_texture2

C 192,192,192

111111111111111
100000000000001
100000000000001
100000100000001
1000000000N0001
100000010000001
100001000000001
1111100000000011111
    100000000000001
    100001010000001
    100001010000001
    100001110000001
    100000000000001
    100000000111111
    1000000001
    1111111111