EA ./assets/textures/HW1.png
NO 		./assets/textures/HW3.png


F 220,100,0
SO ./assets/textures/HW4.png

WE    ./assets/textures/HW2.png
//EA ./path_to_the_east_texture2

C 225,30,0

111111111111111
100000000000001
100000000000001
100000100000001
1000000000Z0001
100000010000001
100001000000001
1111100000000011111
    100000000000001
    100000000000001
    111111111111111