F 103,104,105
C 192,192,192
//C 192,192,192

//EA ./assets/textures/HW1.xpm
EA 	./assets/textures/HW1.xpm
NO 		./assets/textures/HW3.xpm
SO ./assets/textures/HW4.xpm
WE    ./assets/textures/HW2.xpm



111111111111111
100000000000001
100000000000001
100000100000001
100000000000001
100000010000001
100001000000001
1111100000000011111
    10000000E000001
    100000000000001
    111111111111111
