F 103,104,105
C 192,192,192
//C 192,192,192

//EA ./assets/textures/HW1.xpm
EA 	./assets/textures/HW.xpm
NO 		./assets/textures/HW3.xpm


SO ./assets/textures/HW4.xpm
WE    ./assets/textures/HW2.xpm


111111111111111
100000000000001
1000000000N0001
100000100000001
100000000000001
111111111111111
111111111111111111111
1000001111111100000011
1000101   100001111001
1111101111111000000011111
    10000000000001111
    100000000000001
    111111111111111